假名单词速记
あえて - 敢于；并不
いかにも - 实在是
いかなる - 怎样的
いかに - 无论怎样
ありふれた - 常见的
ありとあらゆる - 所有的
あらかた - 大概
あらかじめ - 预先
あやふや - 含糊不清
あやかる - 相似；跟着沾光
あべこべ - 颠倒
あらがち - 不一定（后接否定）
あっけない - 不尽兴
あたかも - 宛如；正好
あくどい - 过浓；恶劣
いずれ - 早晚；反正
いそいそ - 高兴地
いましも - 正是现在
いやに - 异常的（地）
うきうき - 兴奋
うっとうしい - 郁闷；（天气）阴沉
うぬぼれ - 自负
うんざり - 厌烦
おおまか - 粗枝大叶
おおから - 开朗
おさらい - 复习；排练
おっかない - 令人害怕的
おつまみ - 小吃；下酒菜
おっちょこちょい - 毛手毛脚
おどおど - 惴惴不安
おべっか - 奉承
おろそか - 马虎
おんぶ - 背；依靠
ガーゼ - 纱布
かけっこ - 赛跑
かすか - 模糊；微弱
がっくり - 失望
がっしり - 结实
がっちり - 结实的；紧紧；精明
かつて - 曾经
かつてない - 未曾有过的
かねて - 早已
からかう - 嘲笑
カリスマ - 领导魅力/感召力
カルテ - 病历卡
かれこれ - 差不多
かんかん - （日光，火势）熊熊；大发雷霆
がんがん - 唠叨；（头）剧痛
ぎこちない - 笨拙；生硬
きっかり - 正好；清晰
きっちり - 紧紧；精确
きっぱり - 干脆
くしゃくしゃ - 皱巴巴；乱蓬蓬
ぐずぐず - 嘀嘀咕咕；磨蹭
くすぐったい - 发痒；难为情
くすぐる - 挠痒；激发
ぐずつく - 磨蹭；天气阴沉
くたびれる - 疲惫；穿旧
ぐちゃぐちゃ - 粘糊糊；乱七八糟
くっきり - 鲜明（视觉上）
ぐっしょり - 湿透
ぐったり - 精疲力竭
ぐっと - 一口气；一下子
くよくよ - 想不开
クライマックス - Climax
ぐらつく - 动摇
くれぐれも - 周到；仔细
ケーブル - 电缆
げっそり - 急剧消瘦；失望
げらげら - 大笑不止
ごしごし - 用力搓
こつこつ - 孜孜不倦
ことによると - 或许
ごまかす - 蒙骗；糊弄
ごますり - 拍马屁
こまめに - 勤奋地
ささやか - 小
さぞかし - 想必
さては - 原来是；还有
さほど - （并不是）那样xx的xx（后接否定）
さまよう - 彷徨；徘徊
さも - 好像；非常
さもないと - 否则
さらう - 复习
しがみつく - 紧紧抱住
しかるべき - 适当的
しきたり - 规矩
しくじる - 失败；被解雇
シック - 雅致
しでかす - 干出（不好的事）
しどろもどろ - 语无伦次
しなやか - 柔韧；灵活
しばし - 片刻
しぶとい - 倔强；顽固
じゃんじゃん - 连续不断地
しょっちゅう - 经常
しょんぼり - 无精打采
ジレンマ - dilemma
しんどい - 疲劳
スイング - Swing
スタジアム - Stadium
スト - Strike（罢工）
ずばり - 一刀切下；直截了当
ずぶぬれ - 全身湿透
スポンジ - Sponge
スラックス - Slacks
ずらっと - 排长队
ずるずる - 拖拉着
ずれ - 分歧
すれすれ - 掠过；勉强赶上
すんなり - 纤细；容易
せがれ - （自己）儿子
せっせと - 一个劲地
セレモニー - Ceremony
せわしい - 忙碌
###
161011

^ The format is just like this:

<title>
<word01> - <translation01>
<word02> - <translation02>
<...> - <...>
###

And under the "###", you can write anything you want.
